dscKeybusInterface	KEYWORD1
dscClassicInterface	KEYWORD1
dscKeypadInterface	KEYWORD1
dscClassicKeypadInterface	KEYWORD1
dsc	KEYWORD1

dscClockPin	LITERAL1
dscReadPin	LITERAL1
dscWritePin	LITERAL1
dscRelayPin	LITERAL1
dscPC16Pin	LITERAL1
dscZones	LITERAL1
dscPartitions	LITERAL1
dscClassicSeries	LITERAL1
dscKeypad	LITERAL1

hideKeypadDigits	KEYWORD2
displayTrailingBits	KEYWORD2
processModuleData	KEYWORD2

begin	KEYWORD2
stop	KEYWORD2
loop	KEYWORD2
bufferOverflow	KEYWORD2
handleModule	KEYWORD2

write	KEYWORD2
writeReady	KEYWORD2
writePartition	KEYWORD2

statusChanged	KEYWORD2
resetStatus	KEYWORD2
pauseStatus	KEYWORD2
keybusConnected	KEYWORD2
keybusChanged	KEYWORD2
accessCode	KEYWORD2
accessCodeChanged	KEYWORD2
accessCodePrompt	KEYWORD2
timestampChanged	KEYWORD2
ready	KEYWORD2
readyChanged	KEYWORD2
disabled	KEYWORD2
disabledChanged	KEYWORD2
exitDelay	KEYWORD2
exitDelayChanged	KEYWORD2
entryDelay	KEYWORD2
entryDelayChanged	KEYWORD2
armed	KEYWORD2
armedChanged	KEYWORD2
armedAway	KEYWORD2
armedStay	KEYWORD2
noEntryDelay	KEYWORD2
alarm	KEYWORD2
alarmChanged	KEYWORD2
keypadFireAlarm	KEYWORD2
keypadAuxAlarm	KEYWORD2
keypadPanicAlarm	KEYWORD2
trouble	KEYWORD2
troubleChanged	KEYWORD2
fire	KEYWORD2
fireChanged	KEYWORD2
batteryTrouble	KEYWORD2
batteryChanged	KEYWORD2
powerTrouble	KEYWORD2
powerChanged	KEYWORD2
openZones	KEYWORD2
openZonesChanged	KEYWORD2
openZonesStatusChanged	KEYWORD2
alarmZones	KEYWORD2
alarmZonesChanged	KEYWORD2
alarmZonesStatusChanged	KEYWORD2
pgmOutputs	KEYWORD2
pgmOutputsChanged	KEYWORD2
pgmOutputsStatusChanged	KEYWORD2
lights	KEYWORD2
status	KEYWORD2
panelData	KEYWORD2
pc16Data	KEYWORD2
panelVersion	KEYWORD2
lightReady	KEYWORD2
lightArmed	KEYWORD2
lightMemory	KEYWORD2
lightBypass	KEYWORD2
lightTrouble	KEYWORD2
lightProgram	KEYWORD2
lightFire	KEYWORD2
lightBacklight	KEYWORD2
blinkReady	KEYWORD2
blinkArmed	KEYWORD2
blinkMemory	KEYWORD2
blinkBypass	KEYWORD2
blinkTrouble	KEYWORD2
blinkProgram	KEYWORD2
blinkFire	KEYWORD2
blinkBacklight	KEYWORD2
lightZone1	KEYWORD2
lightZone2	KEYWORD2
lightZone3	KEYWORD2
lightZone4	KEYWORD2
lightZone5	KEYWORD2
lightZone6	KEYWORD2
lightZone7	KEYWORD2
lightZone8	KEYWORD2
blinkZone1	KEYWORD2
blinkZone2	KEYWORD2
blinkZone3	KEYWORD2
blinkZone4	KEYWORD2
blinkZone5	KEYWORD2
blinkZone6	KEYWORD2
blinkZone7	KEYWORD2
blinkZone8	KEYWORD2
keyAvailable	KEYWORD2
key	KEYWORD2
beep	KEYWORD2
tone	KEYWORD2
buzzer	KEYWORD2

printPanelBinary	KEYWORD2
printPanelCommand	KEYWORD2
printPanelMessage	KEYWORD2
printModuleBinary	KEYWORD2
printModuleMessage	KEYWORD2
